##############################
##############################
########             #########
#####  0000000000000000  #####
####   0000000000000000   ####
###    00P    00    P00    ###
###    00     00     00    ###
##     00     00     00     ##
##     0000000000000000     ##
##     00     00     00     ##
###    00     00     00    ###
###    00P    00    P00    ###
####   0000000000000000   ####
#####  0000000000000000  #####
#######                #######
##############################