###################
#P0 000000000000 P#
# #0# # # #0# #0# #
#   00   000000 00#
# #0# # # #0#0#0# #
#000000  000  000 #
# # # #0# # # # # #
#  00  00000 000  #
# # # # # # # #0# #
#  000000  000 0  #
# # #0# #0#0# # # #
# 00 00  000  00  #
# #0# #0# # # # # #
#0000000     00000#
# # # # # # # # # #
#  000   000000 00#
# # #0#0# # # # # #
#P0000  0 0000000P#
###################